
1111111111111111111111111111111
10000000000000000C00000000000E1
100P000000000000000000000000001
100000000000C000000000000000001
10100000000000000000000C0000001
1111111111111111111111111111111