11111111111111111
100000001100000E1
10000000000000001
1000011000C011001
10C00000P0C000001
11111111111111111