111111111111111111111111111111111
1P0000000000000000000000000000001
100000001111000011111111000000001
100000011011000011111111000000001
100000110011000000001100000000001
100000000011000011111111000000001
100000000011000011111111000000001
100000000011000000001100000000001
100000000111100011111111000000001
100000000000000000000000000000001
10000000000000CCCCC0000CCCCC00001
1000000000000CCC0CC000CC00CCC0001
100000000000CCC00CC000C0000CC0001
10000000000CCC000CC0000000CC00001
1000000000CCC0000CC000000CC000001
100000000CCC00000CC00000CCCCCCC01
10000000CCCCCCCCCCCCC00CCCCCCC001
10000000CCCCCCCCCCCCC000000000001
10000000000000000CC00000000000001
10000000000000000CC00000000000001
1000000000000000000000000000000E1
111111111111111111111111111111111
