1111111111111111111111111111111
100000000000N0000C00000001000E1
100P000N00001000000100000N00001
100000000000C000000N00000100001
10100000000010000001000C0000001
1111111111111111111111111111111