1111111111111111111111111111111
10000000000000000000000000000E1
100P000000000000000000000000001
1000000000000000000000000000001
1010000000000000000000000000001
1111111111111111111111111111111