1111111111111111111111111111111
11111000000000000C00000000000E1
101P100000000000000000000000001
111110000000C000000000000000001
10100000000000000000000C0000001
1111111111111111111111111111111